.....#....#....#..#....#......................#.....#.#......#..#.#..#.....##..#..#.....#....#..
..............#......##...##......#...#...#................#..........#.........#.............#.
#......#.##..#..#...#..##.#..#....#.#..##..#..#.........#................#..#.............#.....
...#..#......#.#.....#........#.#....#..#..##.#..#..#..#....#...###....#.....#....#........#....
##.............#.........#......#....#####..#####.##..###...#.#..................#...#..........
#....#.......#...#..#...#.............#......#......#...#..................#......#.............
.#..#....#.....#..................#.#..#..#........#.....##........##.#........#.....#...##.##..
..........#.#..##.#..#..#..###......#..#.#.#...#.#..#.......#.#..#.#.#.#.#..#..##.#.#...........
.......#.####...##....##....#.........#......#..#.......................#.........#...#......#..
.....##.#.##..........#..#..........................##...###.....#.#..#.....#.#........#.#......
...#..#..##..................#....##....#..............#..........#......#...#....###.#.....##..
.##.#....#..#..#.#...#.......#.#.#...##.....#..........##............#....#..#........#........#
.#..#...#.#.........#...................#.#.....#.......#.#.........#.#...#..#..#..#..##.#......
..#................##.#..#.....#..#..#..#..#####...#.......##........######..###.#..##.#.##...#.
#.#.##.#.#....####.#........###..#.##....##...##...#....###...#........##.....#...........#.....
.......#..#..#...#.#.....#..###.#....#.#.......##......#.#.#.....####...................#.......
..#...#.....##....#.##......#........#.#.........#.#...........#.....#....#...#....#...#.....#..
.......#.....##........#.......#........................#..#.#...#.......##......#.....#....#...
...#.....#.#.#.....#.....#.............#.###...........#.##.....#.....#....#................#.#.
##..........#...........#...#.....#......##.....##.........#................#.#.......#.#..#....
#..........#..#.....##....##.....##.#....#.#.#.....................#.....##.....#..#.#..........
#...#.#.#.#......#.#.......##..#..#.......#..#.#....#.#.....#....#.#.....#..#..#..####..#..#..#.
#..##.#......#.#.........##...#..###......#.###.#.##..#..#......#.##....#####...##....##...##...
#.....................##.#.....#...#...####...##.#..##....#.#.............#.....#....#...#......
.##...#...##..#.............#....#......##.#....#.....##.............#.....#...#....#..#........
............#.....##.........#..........#...............#...##....#....#.....##..#.#.#..........
......#.........#...........##..#.........#..#........#.....##...#.............#..#...........#.
..#...#..#..##.##.####........#..#..#..#.............#..#..#.##.#..#..#..##.##.#..#........#....
...###....##.#.###.#..#.#........................#.#..#..#.#.###...###.#..##....#........#...#..
....#.........#......#...............#.#...#..#...........#...#............#......#..#.#.....#..
........#..#...........#.........#..........###..#...................#......#...###..#........#.
....#.#..#..###..#......#.............#.#....#............#..........##...#.......#..#..........
....#...........#........#.......#....#............#..........#.........#..#..#..#..#.###..##...
.........###..#.#..#..#..#..#..#.##.#.........###....###...#.....#...####...##....##....#.#.....
.#..#..#....####....##....##..#.#....#.......#............#...#...#.#.#.....#..................#
....#....#....#..#........#.......#...#.....#........###.#....#..........................#......
....#......##.....#.......#...#.##..##...##.....#................##......#......................
....#....#..#...............#......#.##..#..#..##.####..........##.....##.......................
..##....#.......#.............#..#####....##....##....##........#......##...#........##...#.....
#.##....#..........#...#....#.......#.......#...............#....#..#.#...##.......#.........#..
....................#......#.....................##...#...###...##....#.....###.........#.......
#.......#...#....#.###...#.#.#.............#.........###....#.........#..........#.........#.#..
..###...#...#..#..#..#..#.##.....#........#..#.....#.#.##.............##..........#........##..#
#.......####...###....##...##......#.#.....#..##.....###......#...#..#........#.....#....#......
..........#..#..#.#.#.........#.....#......#...#......#.......#..#......##.#.#..#..........#...#
.#.......##................#...#...#...##..#...#...........#..................#.#.#......#......
...................#####.#..#.##..#..#...#.#........#....#.#........#.....#.......###.........#.
.#..#....#......###.#..###...##...##.......#...#....#.#....#...............##.....#.......##....
.....#......##..##.#..####...#..#.......#......#.#............#.....##.......#...#..........#...
...........#.....#..##.#.#...........#...#......#........#.#.....#....#.####......#............#
..###..........#..#..##.#.#...#.......#........##...#..#..#..#..#..#..#.....#..#..........##....
.....#.#.#....#......#......#.......................###.#..##....###...#..#.#......#........##..
.........#.#.#.#..#..###...#...#.#...................#.................#..##.#.#.#...#....#...##
.#.......#....##...#..........#.....#.#....#.........................##..#....#......#.....#....
....#.......#................#......#..#.......#........###...###....#....#............#..#.....
....#..........###......#....#..#................###..#.#.........##......#..........####.......
..#............#.#......##...#.#.#...#.#...............#.#.........#....#..##.....#.............
....#...........#..#...........#..#.###..........#.......##.#......#...#....#...#...#......#...#
.........................#.........##..........#.#....#.........#...........#......#.......#...#
.#...#......##.....#....#..#.#.##..#..##.#..#.....#...........#...##.........#.......#..#......#
....#.....#...............###....##....##....#...............###....#..####...#..#...#.......#.#
..#......#....#....#.......#.#.......#..#.#......##.......#..#.##.###......#.....#.##.#..#.#..#.
.....##......#...............#.......#..........#........##...........#...#.##....##......#...#.
#...#...#.#.........#........#..............#.#....#...#..#.....#...#.#............#....#.##....
....#......#..#....#...#.......##.....##..#.......#.#..#..#.##..#..#.#..........................
...#............#.##..##.#..#..#...#.#.....#.....###.#..###.#.##....#..#....#.#......#......##..
#.#.....#....###..#.##....##...##.#....#..........#...............#.......###..#....#......##...
......##......#.#..........................#.......#...#.#......#.#......#..........#..#.......#
...##..#.......#.#.##........#.....#..#.#.#...##.#...#.#....................#..........##.......
.#.#.#......##.........#.....#...............#..#.....##....#...##....#.#.#.#..........#..#.....
..##.#..#....#.#.........#..........###..#.................#.......#........##.................#
...#..........#..##.#..#..#..##..##.#.........#......#.#...#.........#..#........##.........#...
.........#.###....##....##..#.#...##......#..................#.....#.......#.....#..............
.#....##....##..#.#.............##....##........#....#.#.#............#..#.....#.....#.....#.#..
.....##..........#......#..#......#..#......#....#.#.....##.##..#.##.#####...#.#.............#..
..#.#.....#..............#...#..#...#............#...#####....##....###...#....#.#.#..#...##....
###.#..#...........#................#........#...#......#.#.##.........#.#......#....#.....#....
........#...#......#..#.#....#............#...#............#..#...##....#.......#......#.#...#..
#.#.........#.........#.......#...##..................#........#....#...........#.#..#.#.#....##
............##.##..#..#..#..#..#..#.....#.#.............##........................#......#......
..#...##......#.####.#.##.#..##....#.#...#.#....#..##.#.#.....#...#....#.#.....#.#...#.#.#......
.#..#.#.....#...##...........##.......#.#..........#....#..#..#.#....##.##..............#.......
.###.##.........##..#..#............##.....................#...#....#.....##..#..........#......
##.............#.............#.....#..##.................#.#....#....#....#....#................
..#.#.#..............#.##......#.....#.#.....##........##.#............##.......#.#..#.......#..
##..#......###.....#....#....#..##..#.......................#...#.........#.##............##....
#.....#.#...#.#...............................#..##....#..................#...#..........#.#....
.#.#....#..#.....#....#..#...#....................#..#...#..............#....#..#....#.#........
..#...#......##...#.......##..............#.....#.........#......................#.#..#..#.##...
.#...###...........###.#..#.....................#............#.......................#......#...
#....#.#..##..#....#.......###.......#..##...#.##.#..#..#..#..#....#...........#...#............
...#...........###.#.#...#......#..#........###....##..#.###...###.#.....#...#........##.......#
.#.................#..........#....#......##.#.#.#.#..#...#....#..#............##......#...##...
....#.....#......#...............#....####...#..#.#..#.......#...#.....#.#.#........#.#.......#.
..............###.....##..........#.....#..............#..#........#.....##..##..#....##..#....#
......#...#..#.#...#...#...#.#........#....#..#...#....#........#.................##.#......#.#.